-23
23
-10
14
00000000000000000000000000000000000000000000000
00000000000000000000000000000000000000000000000
01111111111111111111111111111111111111111111110
00000000000010000000000000000000000000000000000
00000000000010000000000000000000000000000000000
00000000000010000000000000000000000000000000000
00000000000111000000000000000000000000000000000
00000000000111000000000000000000000000000000000
01110000000000000000000000000000000000000000000
00000000000000000000000000000000000000000000000
00000000000000000000000000000000011000000000000
00000000000000000000000000111111100000000000000
00000000000010000000000000111111100000000000000
00000000000000000000000000111111100000000000000
01111000000000100000000000111111100000000000000
00000000000000000000000000111111100000000000000
00000000000000000000000000111111100000000000000
00000000000000000000000000111111100000000000000
00000000000000000000000000000000000000000000000
00000000000000000000000000000000000000000000000
01111100000000000000000000000000000000000000000
00000000000000000000000000000000000000000000000
00000000000000000000000000000000000000000000000
00000000000000000000000000000000000000000000000
00000000000000000000000000000000000000000000000
