0
22
-10
0
00000000000000000000000
00000000000000000000000
00000000000000000000000
00000000000000000000000
00000000000000011111110
00000000000000011111110
00000000000000011111110
00000000000001011111110
00000000000001011111110
00000000000001011111110
00000000000001011111110
