-12
36
-18
5
0000000000000000000000000000000000000000000000000
1111111111111111111110111111111111111111111111110
0000000000000000000000000000000000000000000000000
0000000000000000000000000000000000000000000000000
0000000000000000000000000000000000000000000000000
0000000000000000000000000000000000000000000000000
0000000000000000000000000000000000000000000000000
0000000000000000000000000000000000000000000000000
0000000000000000000000000000000000000000000000000
0000000000000000000000000001111111000000000000000
0000000000000000000000000001111111000000000000000
0000000000000000000000000001111111000000000000000
0000000000000000000000000101111111000000000000000
0000000000000000000000000101111111000000000000000
0000000000000000000000000101111111000000000000000
0000000000000000000000000101111111000000000000000
0000000000000000000000000000000000000000000000000
0000000000000000000000000000000000000000000000000
0000000000000000000000000000000000000000000000000
0000000000000000000000000000000000000000000000000
0000000000000000000000000000000000000000000000000
0000000000000000000000000000000000000000000000000
0000000000000000000000000000000000000000000000000
0000000000000000000000000000000000000000000000000
